门诊量	keyword_name
门诊人次	keyword_name
门诊数量	keyword_name
门诊人数	keyword_name	
手术数量	keyword_name
手术数	keyword_name
手术量	keyword_name
手术例数	keyword_name
总收入	keyword_name
住院量	keyword_name
住院人次	keyword_name
住院人数	keyword_name
住院数量	keyword_name
床位使用率	keyword_name
总成本	keyword_name
平均住院日	keyword_name
治愈率	keyword_name
院感人次	keyword_name
医技人次	keyword_name
药品收入	keyword_name
门诊收入	keyword_name
住院收入	keyword_name
死亡率	keyword_name
床位周转次数	keyword_name
预算执行率	keyword_name
业务收支结余率	keyword_name
资产负债率	keyword_name
流动比率	keyword_name
总资产周转率	keyword_name
应收账款周转天数	keyword_name
存货周转率	keyword_name
人员经费支出比率	keyword_name
公用经费支出比率	keyword_name
管理费用率	keyword_name
药占比	keyword_name
总资产增长率	keyword_name
净资产增长率	keyword_name
固定资产净值率	keyword_name
速动比率	keyword_name
手术重返率	keyword_name
住院患者满意度	keyword_name
门诊患者满意度	keyword_name
职工满意度	keyword_name
全院	department
中心医院	department
朔州中心医院	department
本院	department
内科	department
呼吸内科	department
神经内科	department
心血管内科	department
肾内科	department
血液内科	department
免疫科	department
内分泌科	department
心内科室	department
内一科	department
内一科室	department
内二科	department
内二科室	department
消化内科	department
消化内科室	department
外科	department
普通外科	department
神经外科	department
心胸外科	department
泌尿外科	department
心血管外科	department
乳腺科	department
肝胆外科	department
肛肠外科	department
烧伤科	department
骨外科	department
外一科	department
外一科室	department
外二科	department
外二科室	department
骨科	department
急诊科	department
妇产科	department
妇科	department
产科	department
计划生育科	department
妇幼保健科	department
男科	department
儿科	department
儿科综合科	department
小儿内科	department
新生儿科	department
儿童营养保健科	department
五官科	department
耳鼻喉科	department
眼科	department
口腔科	department
肿瘤科	department
肿瘤内科	department
肿瘤外科	department
肿瘤妇科	department
骨肿瘤科	department
放疗科	department
肿瘤康复科	department
肿瘤综合科	department
中医科	department
中医全科	department
中医内科	department
中医外科	department
中医妇科	department
中医儿科	department
中医保健科	department
针灸按摩科	department
中医骨伤科	department
中医肿瘤科	department
中医二科	department
皮肤科	department
性病科	department
皮肤性病科	department
传染科	department
肝病科	department
艾滋病科	department
结核病科	department
精神心理科	department
精神科 department
心理咨询科	department
整形美容科	department
营养科	department
生殖中心	department
麻醉医学科	department
麻醉科	department
疼痛科	department
医学影像科	department
核医学科	department
放射科	department
超声科	department
药剂科	department
护理科	department
体检科	department
检验科	department
设备科	department
防保科	department
体检中心	department
方便门诊	department
手术麻醉科	department
窥镜组	department
康复理疗科	department
手外科	department
碎石专业组	department
最高	keyword_type_max
最多	keyword_type_max
最大	keyword_type_max
最小	keyword_type_min
最低	keyword_type_min
平均	keyword_type_avg
最少	keyword_type_min
同比	keyword_type_yoy
环比	keyword_type_mom
比率	keyword_type_rat
占比	keyword_type_rat
均值	keyword_type_avg